1111111111
1000000111
1110100011
1000011011
1010000011
1010000011
1011111011
1000011001
1000000001
1011011111
1011011$01
1011011101
1011011001
1000000001
1111111111
